3333333333333333333333333333333333333333333
3333333333333333333333333333333333333333333
2222222222222233333333333333332222222222223
1111111111111233333333332222222111111111123
1000000000001233333333322111111100000000123
1000000000001233333333221100000000000000123
1000000000001233333332211000000000000000123
1111111100001233333332110000000000000000123
2222222100011233333332100000000000000000123
3333322100011233333332100000011111111111123
3333332100001233333332100000112222222222223
3333332110001233333332100001122333333333333
3333332110001233333332100001223333333333333
3333332100001233333332100011233333333333333
3333332100011223333322100011233333333333333
3333332100011122222222110001233333333333333
3333332100000111111121110001233333333333333
3333332110000000000111000001233333333333333
3333332210000000000000000011233333333333333
3333333211000000000000000011233333333333333
3333333221000000000000000112233333333333333
3333333321111111110000000122233333333333333
3333333322222222211000001122333333333333333
3333333333333333221111111223333333333333333
3333333333333333322222222233333333333333333
3333333333333333333333333333333333333333333
3333333333333333333333333333333333333333333
3333333333333333333333333333333333333333333
3333333333333333333333333333333333333333333
3333333333333333333333333333333333333333333