300000000000000000000000000000000000000003
300000000000000000000000000000000000000003
300000000000000000000000000000000000000003
300000000000000000000000000000000000000003
300000000000000000000000000000000000000003
300000000000000000000000000000000000000003
300000000000000000000000000000000000000003
300000000000000000000000000000000000111113
300000000000000000000000000000000000000003
300000000000000000000000000000000000000003
300000000000000000000000000000000000000003
311110000000000001111111111111111111111113
322221111111111112222222222222222222222223
333332222222222223333333333333333333333333
333333333333333333333333333333333333333333
333333333333333333333333333333333333333333
333333333333333333333333333333333333333333
333333333333333333333333333333333333333333
333333333333333333333333333333333333333333
333333333333333333333333333333333333333333